அ அ அ அ அ அ அ அ அ அ
அ அ அ அ அ அ அ அ அ அ
அ அ அ அ அ அ அ அ அ அ
அ அ அ அ அ அ அ அ அ அ
அ அ அ அ அ அ அ அ அ அ
ஆ ஆ ஆ ஆ ஆ ஆ ஆ ஆ ஆ ஆ
ஆ ஆ ஆ ஆ ஆ ஆ ஆ ஆ ஆ ஆ
ஆ ஆ ஆ ஆ ஆ ஆ ஆ ஆ ஆ ஆ
ஆ ஆ ஆ ஆ ஆ ஆ ஆ ஆ ஆ ஆ
ஆ ஆ ஆ ஆ ஆ ஆ ஆ ஆ ஆ ஆ
இ இ இ இ இ இ இ இ இ இ
இ இ இ இ இ இ இ இ இ இ
இ இ இ இ இ இ இ இ இ இ
இ இ இ இ இ இ இ இ இ இ
இ இ இ இ இ இ இ இ இ இ
ஈ ஈ ஈ ஈ ஈ ஈ ஈ ஈ ஈ ஈ
ஈ ஈ ஈ ஈ ஈ ஈ ஈ ஈ ஈ ஈ
ஈ ஈ ஈ ஈ ஈ ஈ ஈ ஈ ஈ ஈ
ஈ ஈ ஈ ஈ ஈ ஈ ஈ ஈ ஈ ஈ
ஈ ஈ ஈ ஈ ஈ ஈ ஈ ஈ ஈ ஈ
உ உ உ உ உ உ உ உ உ உ
உ உ உ உ உ உ உ உ உ உ
உ உ உ உ உ உ உ உ உ உ
உ உ உ உ உ உ உ உ உ உ
உ உ உ உ உ உ உ உ உ உ
ஊ ஊ ஊ ஊ ஊ ஊ ஊ ஊ ஊ ஊ
ஊ ஊ ஊ ஊ ஊ ஊ ஊ ஊ ஊ ஊ
ஊ ஊ ஊ ஊ ஊ ஊ ஊ ஊ ஊ ஊ
ஊ ஊ ஊ ஊ ஊ ஊ ஊ ஊ ஊ ஊ
ஊ ஊ ஊ ஊ ஊ ஊ ஊ ஊ ஊ ஊ
எ எ எ எ எ எ எ எ எ எ
எ எ எ எ எ எ எ எ எ எ
எ எ எ எ எ எ எ எ எ எ
எ எ எ எ எ எ எ எ எ எ
எ எ எ எ எ எ எ எ எ எ
ஏ ஏ ஏ ஏ ஏ ஏ ஏ ஏ ஏ ஏ
ஏ ஏ ஏ ஏ ஏ ஏ ஏ ஏ ஏ ஏ
ஏ ஏ ஏ ஏ ஏ ஏ ஏ ஏ ஏ ஏ
ஏ ஏ ஏ ஏ ஏ ஏ ஏ ஏ ஏ ஏ
ஏ ஏ ஏ ஏ ஏ ஏ ஏ ஏ ஏ ஏ
ஐ ஐ ஐ ஐ ஐ ஐ ஐ ஐ ஐ ஐ
ஐ ஐ ஐ ஐ ஐ ஐ ஐ ஐ ஐ ஐ
ஐ ஐ ஐ ஐ ஐ ஐ ஐ ஐ ஐ ஐ
ஐ ஐ ஐ ஐ ஐ ஐ ஐ ஐ ஐ ஐ
ஐ ஐ ஐ ஐ ஐ ஐ ஐ ஐ ஐ ஐ
ஒ ஒ ஒ ஒ ஒ ஒ ஒ ஒ ஒ ஒ
ஒ ஒ ஒ ஒ ஒ ஒ ஒ ஒ ஒ ஒ
ஒ ஒ ஒ ஒ ஒ ஒ ஒ ஒ ஒ ஒ
ஒ ஒ ஒ ஒ ஒ ஒ ஒ ஒ ஒ ஒ
ஒ ஒ ஒ ஒ ஒ ஒ ஒ ஒ ஒ ஒ
ஓ ஓ ஓ ஓ ஓ ஓ ஓ ஓ ஓ ஓ
ஓ ஓ ஓ ஓ ஓ ஓ ஓ ஓ ஓ ஓ
ஓ ஓ ஓ ஓ ஓ ஓ ஓ ஓ ஓ ஓ
ஓ ஓ ஓ ஓ ஓ ஓ ஓ ஓ ஓ ஓ
ஓ ஓ ஓ ஓ ஓ ஓ ஓ ஓ ஓ ஓ
ஔ ஔ ஔ ஔ ஔ ஔ ஔ ஔ ஔ ஔ
ஔ ஔ ஔ ஔ ஔ ஔ ஔ ஔ ஔ ஔ
ஔ ஔ ஔ ஔ ஔ ஔ ஔ ஔ ஔ ஔ
ஔ ஔ ஔ ஔ ஔ ஔ ஔ ஔ ஔ ஔ
ஔ ஔ ஔ ஔ ஔ ஔ ஔ ஔ ஔ ஔ
ஃ ஃ ஃ ஃ ஃ ஃ ஃ ஃ ஃ ஃ
ஃ ஃ ஃ ஃ ஃ ஃ ஃ ஃ ஃ ஃ
ஃ ஃ ஃ ஃ ஃ ஃ ஃ ஃ ஃ ஃ
ஃ ஃ ஃ ஃ ஃ ஃ ஃ ஃ ஃ ஃ
ஃ ஃ ஃ ஃ ஃ ஃ ஃ ஃ ஃ ஃ
ஆ இ உ எ ஒ ஃ
ஐ ஔ அ ஆ இ
எ ஏ ஐ ஒ ஓ
உ ஊ எ ஒ ஐ
அ இ உ எ ஒ
ஆ ஈ ஊ ஏ ஓ
அ ஆ இ ஈ உ
ஊ ஒ ஐ ஔ எ
இ உ எ ஒ அ
ஏ ஓ ஐ ஃ ஔ ஆ
அ அ ஆ இ உ
எ ஒ ஐ ஔ ஏ
ஆ ஈ ஃ ஊ அ இ
உ எ ஒ ஓ ஐ
அ இ எ ஒ உ
ஐ ஔ ஃ ஆ ஈ ஊ
எ ஏ ஒ ஓ ஐ
உ ஊ இ அ ஆ
ஒ ஐ ஔ எ ஏ
ஆ இ உ எ ஒ
அ ஆ ஆ இ இ
உ உ எ எ ஒ
ஐ ஐ ஔ ஔ ஆ
ஈ ஊ ஏ ஓ ஐ
அ இ உ அ இ
எ ஒ ஃ எ ஒ ஐ
ஆ ஈ ஆ ஈ ஊ
ஏ ஓ ஏ ஓ ஐ
உ ஊ உ ஊ எ
ஒ ஐ ஒ ஐ ஔ
அ ஆ இ ஈ உ
எ ஏ ஐ ஒ ஓ
உ ஊ எ ஒ ஐ
ஆ ஈ ஊ ஃ ஏ ஓ
அ இ உ எ ஒ
ஐ ஔ ஐ ஔ அ
இ உ எ ஒ அ
ஏ ஓ ஐ ஔ ஆ
உ எ ஒ ஐ ஔ
ஆ இ உ எ ஒ
அ ஆ அ ஆ இ
உ எ உ எ ஒ
ஐ ஔ ஐ ஃ ஔ ஐ
ஈ ஊ ஏ ஓ ஆ
அ இ அ இ உ
எ ஒ எ ஒ ஐ
ஆ ஈ ஊ ஆ ஈ
ஏ ஓ ஐ ஏ ஓ
உ ஊ எ உ ஊ
ஒ ஐ ஔ ஒ ஐ
அ ஆ இ ஈ உ ஊ
எ ஏ ஐ ஒ ஓ ஔ
அ இ உ எ ஒ
ஆ ஈ ஊ ஃ ஏ ஓ ஔ ஐ
அ அ அ ஆ ஆ ஆ இ இ இ
உ உ உ எ எ எ ஒ ஒ ஒ
அ ஆ இ ஈ உ ஊ எ ஏ ஐ ஒ ஓ ஔ
அ இ உ எ ஒ அ இ உ எ ஒ
ஆ ஈ ஊ ஏ ஓ ஆ ஈ ஊ ஏ ஓ
ஐ ஔ ஐ ஔ ஐ ஔ
